5 5
1 1
1
1
0
0
11111
13331
13331
13321
11111