20 20
1 1
2
3 2
2
1 15 15
1 18 18
1 
1 10 10
11111111111111111111
10121210000000000001
10101010000000000001
10000010000000000001
10001010000000000001
10001010000000000001
10001000000000000001
10001000000000000001
10001000000000000001
10001000000000000001
10001000000000000001
10001000000000000001
10001000000000000001
10001000000000000001
10001000000000000001
10001000000000000001
10001000000000000001
10001000000000000001
10001000000000000001
11111111111111111111