5 5
1 1
1
1
0
0
11111
10121
10101
10001
11111